1111111111111
100101000C0K1
100C01111100
10P011E000011
1111111111111
