1111111111111
10010100000K1
100C011111001
10P011E000011
1111111111111
