1111111111111
10010000000K1
10C0011111001
10P011E00001
1111111111111
