1111111111111111111
10P00K0000000000001
1001000100011100001
10010C0100100010001
10010001000C0010001
1001111100000100001
100000010000100C001
1000C0010K01E000001
1000K00100111110001
1000000000000000001
1111111111111111111
