1111111111111111111111
1000000C00000100000001
10W0000000000000W00001
1101110000111100000001
1E00000000111100000001
1111111100011100000001
1000000000000100000001
1000C0000000P100000001
11011100001111000W0001
1000000000000000000001
1111111111111111111111